#....................................................#
#....................................................#
#....................................................#
#....................................................#
#....................#####...........................#
#.......................................##...........#
#...............""..........###...##..........##.....#
#..##..###..##..##...................................#
#..................................................###
#.............................###....................#
##....##.............................................#
#....................##....##......##....##....##....#
#....................................................#
#........##....##....................................#
#....................................................#
#..........##.....##.................................#
#.................................................#..#
#...........##........#...#...#..#...................#
#...#................................................#
#....."""".........................#..#####...###....#
#.....#......................##......................#
#"""""#.....#........................#...............#
##..........#........................................#
##.......#####............."...""""".................#
######"""#############################################
